Nazi-Rentner	NN	Nazi-Rentner
greifen	VVFIN	greifen
an	APPR	an
alte	ADJA	alt
Schweine	NN	Schwein
bleiben	VVFIN	bleiben
dran	PAV	dran
haben	VAFIN	haben
nur	ADV	nur
noch	ADV	noch
ein	ART	eine
Ziel	NN	Ziel
alles	PIAT	alle
Fremde	NN	Fremde
ist	VAFIN	sein
zuviel	PIAT	zuviele
Diabetes	NN	Diabetes
,	$,	,
Krebs	NN	Krebs
und	KON	und
Raucherbein	NN	Raucherbein
läßt	VVFIN	lassen
sie	PPER	sie
nur	ADV	nur
noch	ADV	noch
lauter	ADJD	laut
schrein	VVFIN	schrein
ihr	PPOSAT	ihr
Lebensinhalt	NN	Lebensinhalt
ist	VAFIN	sein
der	ART	die
Hass	NN	Hass
alte	ADJA	alt
Schweine	NN	Schwein
geben	VVFIN	geben
Gas	NN	Gas
sie	PPER	sie
morden	VVFIN	morden
mit	APPR	mit
System	NN	System
wer	PWS	wer
nicht	PTKNEG	nicht
will	VMFIN	wollen
kann	VMFIN	können
gehn	ADJD	gehn
sie	PPER	sie
kennen	VVFIN	kennen
keine	PIAT	keine
Schranken	NN	Schranke
sie	PPER	sie
morden	VVFIN	morden
in	APPR	in
Gedanken	NN	Gedanke
Rentner-Nazis	NN	Rentner-Nazis
feiern	VVFIN	feiern
Opaschweine	NN	Opaschweine
schauekeln	VVFIN	schauekeln
mit	APPR	mit
den	ART	die
Eiern	NN	Ei|Eiern
den	ART	die
Omaschweinen	NN	Omaschweinen
ist	VAFIN	sein
dies	PDS	dies
Einerlei	NN	Einerlei
die	ART	die
Enkel	NN	Enkel
sind	VAFIN	sein
auch	ADV	auch
dabei	PAV	dabei
